16 32
#This is a comment
E1,E1,E1,E1,E1,E1,E1,E1,E1,E1,E1,E1,E1,E1,E1,E1,E1,E1,E1,E1,E1,E1,E1,E1,E1,E1,E1,E1,E1,E1,E1,E1,E1,E1,E1,E1,E1,E1,E1,E1,E1,E1,E1,E1,E1,E1,E1,E1,E1,E1,E1,E1,
E1,E1,E1,B1,L1,L1,B1,L1,L1,B1,L1,L1,B1,L1,L1,B1,L1,L1,B1,L1,L1,B1,L1,L1,B1,L1,L1,B1,L1,L1,B1,L1,L1,B1,L1,L1,B1,L1,L1,B1,L1,L1,B1,L1,L1,B1,L1,L1,B1,L1,L1,E1,
E1,E1,B1,L1,L1,B1,L1,L1,B1,L1,L1,B1,L1,L1,B1,L1,L1,B1,L1,L1,B1,L1,L1,B1,L1,L1,B1,L1,L1,B1,L1,L1,B1,L1,L1,B1,L1,L1,B1,L1,L1,B1,L1,L1,B1,L1,L1,B1,L1,L1,E1,E1,
E1,E1,E1,B1,L1,L1,B1,L1,L1,B1,L1,L1,B1,L1,L1,B1,L1,L1,B2,L1,L1,B2,L1,L1,B1,L1,L1,B1,L1,L1,B1,L1,L1,B1,L1,L1,B1,L1,L1,B1,L1,L1,B1,L1,L1,B1,L1,L1,B1,L1,L1,E1,
E1,E1,B1,L1,L1,B1,L1,L1,B1,L1,L1,B1,L1,L1,B1,L1,L1,B2,L1,L1,B3,L1,L1,B2,L1,L1,B1,L1,L1,B1,L1,L1,B1,L1,L1,B1,L1,L1,B1,L1,L1,B1,L1,L1,B1,L1,L1,B1,L1,L1,E1,E1,
E1,E1,E1,B1,L1,L1,B1,L1,L1,B1,L1,L1,B1,L1,L1,B1,L1,L1,B2,L1,L1,B2,L1,L1,B1,L1,L1,B1,L1,L1,B1,L1,L1,B1,L1,L1,B1,L1,L1,B1,L1,L1,B1,L1,L1,B1,L1,L1,B1,L1,L1,E1,
E1,E1,B1,L1,L1,B1,L1,L1,B1,L1,L1,B1,L1,L1,B1,L1,L1,B1,L1,L1,B1,L1,L1,B1,L1,L1,B1,L1,L1,B1,L1,L1,B1,L1,L1,B1,L1,L1,B1,L1,L1,B1,L1,L1,B1,L1,L1,B1,L1,L1,E1,E1,
E1,E1,E1,B1,L1,L1,B1,L1,L1,B1,L1,L1,B1,L1,L1,B1,L1,L1,B1,L1,L1,B1,L1,L1,B1,L1,L1,B1,L1,L1,B1,L1,L1,B1,L1,L1,B1,L1,L1,B1,L1,L1,B1,L1,L1,B1,L1,L1,B1,L1,L1,E1,
E1,E1,B1,L1,L1,B1,L1,L1,B1,L1,L1,B1,L1,L1,B1,L1,L1,B1,L1,L1,B1,L1,L1,B1,L1,L1,B1,L1,L1,B1,L1,L1,B1,L1,L1,B1,L1,L1,B1,L1,L1,B1,L1,L1,B1,L1,L1,B1,L1,L1,E1,E1,
