32 32
#This is a comment
E1,E1,E1,E1,E1,E1,E1,E1,E1,E1,E1,E1,S1,E1,
E1,E1,E1,E1,E1,B1,E1,E1,E1,E1,E1,E1,S1,E1,
E1,E1,E1,E1,E1,E1,E1,E1,E1,E1,E1,E1,S1,E1,
E1,E1,E1,E1,E1,E1,E1,E1,E1,E1,E1,E1,S1,E1,
E1,E1,E1,E1,E1,E1,E1,E1,E1,E1,E1,E1,S1,E1,
E1,E1,E1,E1,E1,E1,E1,E1,E1,E1,E1,E1,S1,E1,
E1,E1,E1,E1,E1,E1,E1,E1,E1,E1,E1,E1,S1,E1,
E1,E1,E1,E1,E1,E1,E1,E1,E1,E1,E1,E1,E1,E1,
